0,0,0,0,0,0,0,0
0,0,0,0,0,0,0,0
0,0,0,0,0,0,0,0
0,0,15,0,0,0,0,0
0,0,5,6,6,0,0,0
0,0,5,0,5,0,0,0
0,0,5,4,5,0,0,0
0,0,6,4,5,0,0,0
