16,4,4,4,4,4,4,4
6,0,0,0,5,5,5,4
4,4,5,5,6,0,4,4
4,4,4,0,6,5,4,4
5,4,6,5,6,5,6,0
4,4,4,5,6,5,6,0
4,4,4,4,5,5,5,0
4,4,6,6,6,6,6,0
