0,0,0,0,0,0,0,0
0,0,0,0,0,0,0,0
5,4,4,4,5,4,4,14
5,4,4,4,4,5,4,5
5,4,5,4,5,4,5,4
5,5,5,5,5,5,4,5
5,4,5,5,4,4,4,4
4,4,4,5,4,4,4,4
