0,0,0,0,0,0,0,0
0,0,0,0,0,0,0,0
0,4,4,5,5,4,5,6
4,4,4,5,6,5,16,6
5,0,0,0,6,5,6,6
5,5,5,5,6,4,6,6
4,4,5,4,5,4,6,6
4,4,6,6,6,6,6,6
